31111111101110111114
2*v***b**2...2v****2
2*314*34*51118*314*2
2*2.2*22*****2*2.2*2
2*516*59110118*516*2
2***v*****7118*****2
714*1111106..51114*2
2*2******2.......2*2
2*511114v511111018*2
2******2*******718*2
71111**7111111*2.2*2
2*v***16*******516*2
74********111******2
76*1114*2**v*34*1118
2*****2*7114*56**v*2
2a314*2*2.36***314*2
2*2.2*2*2.2@*2*2.2*2
2*516***2.5118*516*2
2***v*316....2*****2
51111191111119111116