31111111111111111114
2*************v****2
2**311111111111114*2
2**2v******@*****2*2
2**2*3111110111116*2
2**2*******2*****v*2
2**5111111*2*31114*2
2************2***2*2
2**311114******2*2*2
7116*********71916*2
2**a**314**********2
2v2***506*31**114**2
2*2*0**2**2*****2**2
2*2*2**2**511*306**2
2*2*9**2******794**2
2*2*******v***2.2**2
2*5111118**711916**2
2********v********b2
2******311114******2
51111119111191111116  