31111111111111111114
2***v**************2
2*114*@*****3**34**2
2***2*******2**22**2
2*118*51114*2**22**2
2***2*******2*3994*2
2*116*******6*2**2*2
2*******v**********2
2*311**1114*31*114*2
2v2*************b2*2
2*2**************2*2
2*51111*116*511*16*2
2****c*************2
2*314*3***v***2**2*2
2*2.2*2*******2**2*2
2*508*2*51114*7118*2
2*362*2*******2*v2*2
2*2*2v6*******2**2*2
2a*****************2
51111119111191111116