31111111111111111114
2****************v*2
2**311111111111114*2
2**2***v***@*****2*2
2**2*3111110111116*2
2*v2*******2*******2
2**5111111*2*31114*2
2************2***2*2
2b*311114******2*2*2
7116*********71916*2
2*****314******v***2
2*2***506*31**114**2
2*2a0**2**2*****2**2
2*2*2**2**511*306**2
2*2*9**2*v****794**2
2*2***********2.2**2
2*5111118**711916**2
2***v**************2
2******311114*****c2
51111119111191111116  