31111111111111111114
2******************2
2**34*********314**2
2*v22********@2.2**2
2**22*51114***2.2**2
2*3994********718**2
2*2**2****v***2*2**2
2****************v*2
2*311**1114*31*114*2
2*2*************b2*2
2*2******v*******2*2
2*51111*116*511*16*2
2v*********c*******2
2*2**2*3******314**2
2*2**2*2***v**2.2**2
2*7118*2*51114508**2
2*2**2*2******362**2
2*2**2*6******2*2**2
2a********v******v*2
51111119111191111116